推,噓,分數,作者,標題,時間
13,4,9,sonyoung (youngson),[問卦] 在都是女生的環境工作是不是要小心,Sat Feb  6 03:21:39 2021
8,8,0,ivonie5566 (強烈譴責趙又廷抄襲5566),[問卦] 愛莉莎莎絕美照曝光 網驚：上海灘賭聖？,Fri Feb  5 22:37:39 2021
12,0,12,aivxg (家裡窮西索XD),[問卦] 其實雞排妹是防疫大使吧,Fri Feb  5 22:24:40 2021
2,1,1,ocean1025 (人生海海),[問卦]關於 電影第六感生死緣,Sat Feb  6 00:48:51 2021
2,2,0,rd5186 (GIOS),[問卦] 按照這個情勢，翁立友是不是還可以出這招,Fri Feb  5 22:49:34 2021
13,0,13,magic543 (何布),[問卦] 罷免案的討論度是不是被雞排妹吸走了,Fri Feb  5 23:16:14 2021
5,0,5,juicypussy (多汁小貓咪),[問卦] 什麼時候會脫口說出「垃圾」,Sat Feb  6 03:48:30 2021
5,6,-1,ex250203 (我是肥宅我驕傲),[問卦] 被性騷擾其實很爽吧,Fri Feb  5 22:09:52 2021
4,0,4,dean1990 (狄恩院長),Re,Sat Feb  6 06:51:54 2021
8,0,8,huyee (瘋狗),[問卦] clubhouse 跟ptt 哪個比較優越？,Sat Feb  6 02:32:01 2021
7,1,6,Beanoodle (津崎似超人平匡先生),[問卦] 雞排妹要是生在日本是不是沒人敢搭電車？,Sat Feb  6 08:08:01 2021
8,0,8,mongi (大體老屍),[問卦] 清潔隊是不是都有背景？,Sat Feb  6 09:21:16 2021
36,8,28,combo999 (---),[新聞] 台股封關無緣萬六 股民鼠年平均賺121.5萬,Fri Feb  5 23:07:25 2021
3,1,2,cpz (我是閃亮亮的鑽石),[問卦] 去半套店會被告性騷擾ㄇ？,Sat Feb  6 00:21:35 2021
6,1,5,emperor (派蘿派蘿得第一),[問卦] 与田祐希與我的下午茶約會?,Fri Feb  5 22:59:45 2021
8,0,8,PrinceKanto (生田絵梨花は俺の嫁),[問卦] 孤狼之血會是乃木坂西野七瀬最適合戲路嗎,Fri Feb  5 22:20:47 2021
5,0,5,maxjack (),[問卦] 當初尾牙場是唱這首歌嗎？,Sat Feb  6 02:22:49 2021
2,3,-1,moai513 (523),[問卦] 地瓜片吃會到嘴巴破掉怎麼辦?,Sat Feb  6 00:00:14 2021
6,0,6,DarkHolbach (黑道公子讓你變失業魯蛇),Re,Fri Feb  5 23:52:24 2021
1,6,-5,great5566 (陳央),Re,Sat Feb  6 07:26:24 2021
5,1,4,seabox (盒盒),[問卦] 胤礽是多爛 被康熙廢兩次,Sat Feb  6 01:14:07 2021
29,17,12,ioupoiu (他媽的噁心甲),[新聞] 告遲緩男的他是「六寶爸」曾是法律高材?1,Fri Feb  5 22:09:27 2021
9,2,7,konanno1 (柯南不一),[問卦] G排妹的討論到底可以洗多久,Sat Feb  6 00:27:13 2021
4,2,2,masi (專業酸民),[問卦] 柯以柔前夫跟王剛比誰比較厲害,Sat Feb  6 00:31:18 2021
3,1,2,ceramicfa (ceramicfa),[問卦] 展鈔5秒鐘展90度 可以去銀行上班了嗎?,Fri Feb  5 22:35:17 2021
1,1,0,purplvampire (阿修雷),[新聞] 臺北市與亞太電信聯手啟動5G專網智慧醫療,Fri Feb  5 22:16:44 2021
89,40,49,ubcs (覺★青年超冒險蓋),[公告] 愛莉莎莎殺手 水桶發錢,Sat Feb  6 01:39:21 2021
34,3,31,richshen (哇哈哈),[問卦] 三年後翁立友在鄉民眼中是什麼評價?,Sat Feb  6 03:29:17 2021
9,0,9,QQKKQKQK (QK啦!),[問卦] 憾！下線等。櫻木的千年殺算是性騷擾嗎？,Fri Feb  5 22:30:04 2021
0,3,-3,akumakei (他們想要強奸我),[問卦] 最希望誰來代言MLB  Josh：愛莉莎莎,Sat Feb  6 00:21:08 2021
4,1,3,fatslave (),[問卦] 被女生用皮鞭抽打 滴蠟 總不會被告吧,Sat Feb  6 00:03:04 2021
3,3,0,flamevein (ACCET),[問卦] 魔法師轉職該怎麼慶祝,Sat Feb  6 01:03:29 2021
4,0,4,ich2 (北川石原都是我老婆),[問卦] 台北捷運怎麼還不改掉手扶梯站右邊？,Fri Feb  5 22:56:22 2021
9,2,7,eva577663 (˙(00)˙),[新聞] 板橋女控遭性騷擾　她竟在賣場噴防狼噴,Fri Feb  5 23:40:30 2021
1,2,-1,DCSHK (耳機),[問卦] 該發起WFM運動了嗎?,Sat Feb  6 08:27:20 2021
5,1,4,tony77998 (偷尼柒柒玖玖捌),[問卦] 為什麼清朝鴉片時代沒有出大藝術家,Fri Feb  5 23:05:12 2021
3,0,3,a6000200 (aa),[問卦] 女生是不是不用怕沒飯吃,Sat Feb  6 00:54:22 2021
8,3,5,S9125126 (SS),[問卦] 是不是只要長的帥 風趣　幽默　就安全？,Sat Feb  6 08:39:16 2021
13,0,13,sodistrues (true),[問卦]三國曹爽犧牲家人戰到底能打贏司馬懿嗎？,Sat Feb  6 08:42:35 2021
2,0,2,wnglon (冷面笑匠),[問卦] 性騷擾完女生後,Sat Feb  6 07:20:16 2021
8,0,8,asdzxc1662 (樂活吧),[問卦] 今年過年還會有甄嬛馬拉松嗎？,Fri Feb  5 22:38:13 2021
10,0,10,osalucard (墮落的月光),[問卦] 如果今天雞排妹是男的，會怎樣發展？,Sat Feb  6 07:52:54 2021
14,3,11,Kevin73910 (Bubu),[問卦] 男生被性騷擾好像都不在乎?,Sat Feb  6 00:14:54 2021
21,5,16,abc7360393 (小貓z),[問卦] 沒抵押沒工作，要怎借得到合法的錢,Sat Feb  6 05:03:38 2021
79,4,75,link4517 (link4517),[問卦] 阿-都兩點了，還沒睡的各位在幹嘛呢？,Sat Feb  6 02:18:38 2021
8,23,-15,alexhsu0909 (),[問卦] 這個時間點沒凶宅了吧,Sat Feb  6 03:51:51 2021
0,0,0,gk1329 (),[問卦] 有沒有可能全部都是套好的,Sat Feb  6 09:31:22 2021
2,2,0,noname78531 (1+1=0),[問卦] 身體被奴化習慣假日也早起怎麼辦,Sat Feb  6 08:05:06 2021
5,0,5,zj4gjcl6 (無言以對),Re,Fri Feb  5 22:50:35 2021
7,1,6,GonVolcano (火山君),[問卦] 各位平常會不會覺得被雞排性騷擾啊,Fri Feb  5 23:07:13 2021
22,1,21,TyuzuChou (子瑜我老婆),[問卦] 為什麼快銀換人演了？,Sat Feb  6 06:42:23 2021
5,12,-7,leavez (XD),[問卦] 被性騷當下大叫很難嗎,Fri Feb  5 23:40:54 2021
0,0,0,leavez (XD),[問卦] 豬哥亮摸的話算性騷擾嗎?,Sat Feb  6 09:25:59 2021
0,1,-1,s523698 (523698),[問卦] 一句話跟她毀婚？,Sat Feb  6 00:16:23 2021
4,0,4,cpz (我是閃亮亮的鑽石),[問卦] 有沒有自卑感的八卦？,Fri Feb  5 23:00:55 2021
1,0,1,keepwild (牛奶糖),Re,Sat Feb  6 03:49:37 2021
7,7,0,abc89664k (翔大),[問卦] 現代小龍女追殺尹志平,Sat Feb  6 05:13:18 2021
3,8,-5,"god46 (大家好,我是JayJay林俊傑)",[問卦] 預測你的未來十天，相信請推文,Sat Feb  6 08:07:26 2021
7,0,7,mycity16 (革命尚未成功),Re,Fri Feb  5 22:32:33 2021
4,6,-2,a78914124 (U文製造機),[問卦] 雞排妹的風格484很像韓導,Fri Feb  5 23:26:46 2021
9,0,9,a15568 (玉米),[問卦] 翁直接說自己是甲甲是不是就翻盤了？,Sat Feb  6 00:47:46 2021
4,0,4,hayate232 (CY),Re,Fri Feb  5 23:38:41 2021
8,6,2,ulycess (ulycess),[問卦] 以後主持人是不是可以隨便拍女星的臀部了,Fri Feb  5 23:23:11 2021
4,2,2,Refauth (山丘上的長號手),[問卦] 為什麼捷運沒有 男性專用車廂 ？,Sat Feb  6 01:06:58 2021
4,0,4,NARUTO (鳴人),[問卦] 覺青對臺灣與朝鮮半島的主權看法不一致？,Fri Feb  5 22:46:08 2021
9,0,9,kevin05233 (kk),[問卦] 舒淇是不是很好的對照組？,Sat Feb  6 03:09:34 2021
92,1,91,randy211161 (一生只愛みおな♡),[問卦] 發錢♡祝乃木坂小可愛星野みなみ生日快,Fri Feb  5 23:32:18 2021
7,1,6,SUMPO (盛保),[問卦] 搞不懂貓貓想要甚麼 腫魔半,Sat Feb  6 01:21:01 2021
7,1,6,gerychen (邪惡肥宅),[問卦] 是不是該先提出被性騷擾保身比較好？,Sat Feb  6 07:59:07 2021
7,8,-1,BleedWang (),[問卦] 翁立友幹嘛不直接告毀謗,Fri Feb  5 23:11:48 2021
8,2,6,crassus7217 (肯德鴨),[問卦] 13年後PTT還會存在嗎？？,Sat Feb  6 08:11:34 2021
2,1,1,qazp741 (綠豆),Re,Sat Feb  6 02:49:21 2021
1,0,1,bingogobin (  ),[問卦] 來福是不是有證據才安全下莊？,Sat Feb  6 08:23:48 2021
3,0,3,masi (專業酸民),Re,Fri Feb  5 22:32:14 2021
18,1,17,lpbrother (LP哥(LP = Love & Peace)),[問卦] 支持黃宥嘉醫生的都是媳婦嗎？,Sat Feb  6 08:26:45 2021
20,3,17,ex250203 (我是肥宅我驕傲),[問卦] 一直洗雞排妹被性騷擾是想掩蓋什麼大事,Fri Feb  5 22:48:12 2021
1,0,1,wade6510 (真情不必多說),[問卦] 花多少補習費後 快打旋風才變職業玩家?,Sat Feb  6 09:16:27 2021
5,0,5,GraceMa (我喜歡騎馬),[問卦] 為什麼會流行不健康的審美,Sat Feb  6 01:59:02 2021
63,4,59,TKHAZ (FR762088),[問卦] 慟！clubhouse聽到現在,Sat Feb  6 04:19:43 2021
0,0,0,keyesleo (以前曾經很帥),Re,Fri Feb  5 23:30:11 2021
1,6,-5,E6300 (＊靈界偵探＊),有沒有可能女生今天說給你摸  明天說性騷擾,Fri Feb  5 23:26:28 2021
20,2,18,MartianIT (Martian Institute Tech),[新聞] 英國撤銷中國環球新聞網執照,Sat Feb  6 07:35:35 2021
6,16,-10,alex1987 (基努李維),[新聞] 中國打壓 蓋亞那撤「台灣辦公室」陳柏惟:,Sat Feb  6 00:52:43 2021
22,2,20,loken0408 (男人野蠻劍),[新聞]成績太好遭妒女高中生被同班同學餵毒蛋糕,Sat Feb  6 01:21:26 2021
17,2,15,hayato24 (樹枝孤鳥),[問卦] 機排妹這樣算不算妨礙風化??,Sat Feb  6 05:45:26 2021
50,13,37,genheit (genheit),[問卦] 金庸最後一部武俠小說為何亂寫？,Fri Feb  5 22:30:42 2021
50,5,45,tunisco (終極魯蛇),[問卦] 身邊女性朋友對G翁事件的看法,Sat Feb  6 07:43:52 2021
23,2,21,awei6225 (參零陸捌),[新聞] 中國人口加速塌陷 部分地區出生率大掉32%,Fri Feb  5 23:46:45 2021
11,1,10,kapasky (偽卡巴斯基),[問卦] 現實生活沒人在關心雞排妹事件？,Sat Feb  6 08:20:57 2021
42,7,35,jkkert (沙皮、巴哥傻傻分不清楚),[問卦] 急問，捷運上妹子睡著靠到我手臂了,Sat Feb  6 00:23:32 2021
2,3,-1,orangelolly (我戀橘羅莉。夏流),[問卦] 有誰跟我一樣開始放年假了?,Fri Feb  5 23:37:56 2021
4,0,4,jackliao1990 (j),[新聞] 參考太陽磁重聯巨大能量，新型電磁推進器,Sat Feb  6 00:02:00 2021
3,1,2,littlest (讀冊人...),[問卦] 今天的空氣好差.....,Sat Feb  6 00:41:18 2021
17,10,7,Reichenau (RRR),[新聞] 網列記者會5大敗筆！翁立友「挨轟媽寶」,Fri Feb  5 22:59:27 2021
2,3,-1,jimmysunny01 (但願長醉不願醒),[問卦] 當過兵的還會吃部隊鍋嗎？,Sat Feb  6 00:21:47 2021
15,4,11,AllBlack (All Black),[問卦] 有沒有四叉貓在講古的卦？,Sat Feb  6 01:49:57 2021
437,27,410,craig5566 (飛天少女豬),[問卦] Ptt 八卦鄉民的Clubhouse房開張了！？,Sat Feb  6 01:35:53 2021
5,6,-1,lupin2401 (信長肛森蘭),[爆卦] 橘子退出電玩展用武漢肺炎發公告被指辱,Sat Feb  6 00:35:34 2021
7,0,7,cloudyheart (雲心),Re,Sat Feb  6 02:49:41 2021
22,1,21,OAO5566 (OAO),[問卦] 為啥一堆人都學樂器之王：鋼琴？,Fri Feb  5 22:36:37 2021
1,6,-5,spiral0857 (從今以後),[問卦] 正妹驚嚇，露出傻眼可愛的表情。,Fri Feb  5 23:21:50 2021
2,1,1,kerorobear (解放君愛肛交),[問卦] 各位性騷擾犯們晚安,Sat Feb  6 01:57:14 2021
10,1,9,NCTUEE800808 (White Dragon Society),[問卦] 變得害怕女森怎摸辦？,Sat Feb  6 03:05:12 2021
3,0,3,jackyiou (銀翼的魔術師),[問卦] 翁立友上狗屎寫手會被怎麼寫,Fri Feb  5 22:15:04 2021
52,0,52,derekhsu (華麗的天下無雙),[爆卦] 疫情整理:疫情緩解穩定行 歐洲三國隱憂起,Fri Feb  5 22:42:40 2021
3,11,-8,realtw (realtw),Re,Fri Feb  5 23:38:41 2021
4,1,3,intrepid123 (勇氣),[問卦] 哪些女明星47歲可以跟金城武pk,Fri Feb  5 23:13:09 2021
8,4,4,m4vu0 (m4vu0),[問卦] 工作被狂狗幹怎麼辦,Fri Feb  5 22:24:13 2021
6,2,4,YU0121 (愛玉冰™),[問卦] 清捷隊明天有上班嗎？,Fri Feb  5 23:03:22 2021
6,4,2,BrandonRoy7 (優文製造機),[問卦] 女同事每天都穿很性感算不算性騷擾,Sat Feb  6 08:51:02 2021
11,0,11,PrinceKanto (生田絵梨花は俺の嫁),[問卦] 坂道御三家是哪三位? 會全都是乃木坂嗎?,Sat Feb  6 00:25:57 2021
10,1,9,devidevi (凱特),Re,Sat Feb  6 00:11:35 2021
6,5,1,w1230319 (龜山金城武),[問卦] GS版是在選市長還是選版主,Sat Feb  6 08:23:54 2021
14,13,1,chester0312 (阿義),[新聞] 賠我36萬！闖馬路遭撞斷手　男求償碰壁,Sat Feb  6 00:01:22 2021
436,26,410,GentleJena (耶拿),[問卦] 果然翁早就不是第一次性騷擾了,Fri Feb  5 23:33:51 2021
5,2,3,ganynian (感靈羊),[問卦] 為什麼女生出門那麼慢？,Sat Feb  6 05:52:24 2021
1,0,1,inderal (伏羲),Re,Sat Feb  6 01:09:29 2021
8,0,8,ga652206 (Sing),Re,Sat Feb  6 08:19:12 2021
8,17,-9,hugh509 ((0_ 0)),[問卦] 安卓使用者為什麼不承認是科技次等人？,Sat Feb  6 07:17:59 2021
6,1,5,poonebetty (小肥媽),[問卦] 憲哥進來一下,Fri Feb  5 22:26:20 2021
19,8,11,ivorysoap (ivorysoap),Re,Sat Feb  6 02:09:02 2021
5,1,4,theskyofblue (天空藍),[問卦] 如果不想有性慾的時候被激發算被騷擾嗎,Sat Feb  6 04:11:42 2021
7,1,6,Fujiwarano (獨孤浪客號：),[問卦] 一個中國原則是不是中國共產黨的遮羞布?,Sat Feb  6 00:29:21 2021
0,2,-2,oneoneeight (118),[問卦] 碰瓷妹有沒被摸卡稱484陰毛論啊？,Fri Feb  5 22:45:44 2021
3,0,3,longyin (龍吟很難嗎？為什麼),Re,Sat Feb  6 08:09:42 2021
22,2,20,arsonlolita (蘿莉都布羅利),[公告] 八卦板板規(2020.11.21),Sat Nov 21 23:11:42 2020
2,1,1,nonocom (),Re,Sat Feb  6 08:49:19 2021
3,0,3,LaAc (深淵戰士),Re,Fri Feb  5 23:18:11 2021
8,11,-3,seabox (盒盒),[問卦] XXXXGAY洗白了？,Sat Feb  6 02:36:36 2021
86,3,83,bul (腹內原來草莽),[問卦] 昨天雞排妹身旁有位紳士護花是誰啊?!,Sat Feb  6 09:00:26 2021
5,0,5,Neverfor (八卦蟑螂),[問卦] 趁現在蹭一波女權有加分嗎,Sat Feb  6 01:44:19 2021
1,3,-2,akumakei (他們想要強奸我),Re,Sat Feb  6 00:56:22 2021
13,8,5,ReiKuromiya (ReiKuromiya),[問卦] 日本女主播神秘抖動,Sat Feb  6 00:04:17 2021
2,1,1,quan0120 (唯一信仰),[問卦] 我可以代表新生代上clubhouse嗎?,Sat Feb  6 02:29:57 2021
1,1,0,minifat (..........),[問卦] 我該怎操作我的國民情人,Sat Feb  6 00:52:12 2021
5,2,3,strike519 (噓我者 宅友也),Re,Sat Feb  6 09:10:30 2021
4,6,-2,xinyi101 (小愛茶),[問卦] 這塊雞排臭掉了,Fri Feb  5 23:20:14 2021
13,5,8,WangCM (待業中),[問卦] 覺得被雞排妹性騷擾了怎麼辦,Sat Feb  6 07:50:34 2021
4,10,-6,Tattoo (沒有什麼是永遠不變的),Re,Fri Feb  5 23:22:23 2021
3,6,-3,Huangw (wei),Re,Sat Feb  6 00:28:25 2021
17,8,9,deepdish (Keep The Faith),[新聞] 馬英九拍賀歲片上街辦年貨　尷尬！久沒搭,Fri Feb  5 23:30:53 2021
3,2,1,lesnaree2 ( ),[問卦] 性教育有重視兩性平等嗎,Sat Feb  6 00:33:42 2021
3,2,1,cwh0105 (Ex咖哩棒),[問卦] 台灣人是不是個性奴啊?,Sat Feb  6 01:06:54 2021
5,0,5,chadmu (查德姆),[問卦] 全身癌細胞還可以算是同一個人嗎,Fri Feb  5 22:34:46 2021
1,0,1,masterkobe (球球),Re,Fri Feb  5 23:17:13 2021
380,46,334,ntlutw (Louis888),[新聞] 雞排妹遇性騷擾先開記者會？婦團憾：錯誤,Fri Feb  5 23:39:05 2021
29,16,13,aurior (ari),Re,Sat Feb  6 00:28:26 2021
23,3,20,snakei14702 (sun抓奶廷已經gg了怎麼?:),[問卦] 雞排妹是不是有點作秀過頭了？,Sat Feb  6 01:28:04 2021
1,1,0,AWNESS (祈揚ESS),Re,Sat Feb  6 07:05:25 2021
8,0,8,ntlutw (Louis888),[問卦] 某女有創傷症候群嗎 ?,Sat Feb  6 07:09:43 2021
28,0,28,fawangching (Tom),[問卦] 好相處 但沒有企圖心 適合什麼工作？,Sat Feb  6 08:42:56 2021
8,1,7,lpbrother (LP哥(LP = Love & Peace)),[問卦] 鄉民會有幻想朋友嗎？,Sat Feb  6 07:58:28 2021
80,6,74,gogosonny (狗狗桑妮),[問卦] 翁以後是不是只能跟這個拳擊手一樣了?,Sat Feb  6 00:59:04 2021
16,0,16,ytkuang (就是那個光),[新聞] 昔日「燒肉粽事件」？新北男遭墜樓婦人,Sat Feb  6 07:50:37 2021
3,5,-2,ben780413 (V6王),[問卦] 百萬小學堂 容容有男友嗎?,Sat Feb  6 00:06:27 2021
23,2,21,moriyako (何妨吟嘯且徐行),[問卦] 被醜女素懶覺會勃起嗎？,Fri Feb  5 22:43:48 2021
36,7,29,moneybuy (),[問卦] 為啥雞排妹在場翁立友記者會死不開始?,Sat Feb  6 00:33:42 2021
0,3,-3,smreignqrop (Mr.齊),[問卦] 朋友額頭被別人用棒子畫一個疤痕該腫摸,Sat Feb  6 01:12:41 2021
32,2,30,uNFreeman (我愛喵星人~*),[問卦] 為什麼憲哥還沒評論性騷擾事件,Fri Feb  5 22:12:16 2021
2,0,2,hayato24 (樹枝孤鳥),Re,Sat Feb  6 09:15:47 2021
2,3,-1,JUNOCARE (陽光！！),[問卦] 看到肥宅的臉覺得噁心想吐可告他性侵嗎,Sat Feb  6 00:57:44 2021
9,3,6,jrxcombine (浪人中.....),[問卦] 有沒有麥當勞點漢堡會被加蛋的八卦？,Sat Feb  6 07:28:01 2021
6,0,6,z5419 (邱哥),[問卦] 自行車車手的衣著,Sat Feb  6 09:09:39 2021
2,1,1,nonnon (にゃんぱすー),[問卦] 有沒有音樂課的八卦？,Fri Feb  5 23:20:40 2021
0,1,-1,tigotigo (鐵劍-中立理性選民),[問卦] 有沒有歌手鄭家純的八卦？,Sat Feb  6 00:06:10 2021
1,1,0,subway0983 (巴巴),[問卦] 耶！三點了！！,Sat Feb  6 03:22:06 2021
4,3,1,elec1141 (木村拓哉),[問卦] 這輩子想一直聽的演唱會,Fri Feb  5 22:47:48 2021
1,0,1,poonebetty (小肥媽),[問卦] 豆導會如何評論雞排,Sat Feb  6 00:23:52 2021
458,60,398,u35k6 (漫畫),Re,Sat Feb  6 00:49:01 2021
1,2,-1,sillyxsilly (唏哩唏哩),[問卦] 這裡都沒老人了嗎？,Sat Feb  6 02:34:46 2021
178,7,171,funasake (),[問卦] 如果只能推薦一齣日劇，推哪部？,Fri Feb  5 23:51:50 2021
2,3,-1,Sukanku (スカンク),[問卦] 祖國的疝液吹過來了？,Sat Feb  6 00:24:59 2021
21,2,19,garyasdf (MRcan),[問卦] 到底怎樣算性騷擾？,Sat Feb  6 08:07:47 2021
5,0,5,YU0121 (愛玉冰™),Re,Fri Feb  5 23:15:03 2021
3,5,-2,wakaura (wakaura),[問卦] 該怎麼做才能增加睡意?,Fri Feb  5 23:51:59 2021
8,2,6,zerobx (隨意),[問卦] 為啥被性騷擾不敢提告？,Sat Feb  6 01:32:00 2021
1,1,0,newwu (說不定我一生涓滴廢文),Re,Sat Feb  6 02:41:06 2021
6,0,6,shadleheart (雪兜哈特),[問卦] 還有多少鄉民知道傑夫大大？,Sat Feb  6 01:36:52 2021
4,2,2,Xaymaca (夏),[問卦] 中國文化   婚鬧   尾牙   你敢嘴???????,Sat Feb  6 09:01:34 2021
4,1,3,T3T (G.S.M.W),[問卦] 咪兔元年  會改善少子化問題,Sat Feb  6 02:57:26 2021
2,1,1,bodhi (????),Re,Fri Feb  5 22:10:02 2021
2,4,-2,piggy37 (小時),[問卦] 宣布本週是性騷擾週,Fri Feb  5 23:45:13 2021
3,0,3,Ironstick (鋼鐵蛇),[問卦] 最後才知道好朋友其實沒掛掉的八卦？,Sat Feb  6 01:24:48 2021
0,0,0,ncuEE (NCUEE),[問卦] 只有我覺得雞排妹在鋪從政之路嗎？,Sat Feb  6 09:25:37 2021
3,0,3,xxxluke (我手裡拿著小皮鞭),[問卦] 踩到洨就會得菜花？,Sat Feb  6 01:35:31 2021
28,3,25,Bluedicker (藍迪克),[新聞] 初代玉女偶像沈雁在美逝世享年60歲,Fri Feb  5 23:24:00 2021
7,0,7,Emerson158 (紅豆 X 八嘎 X 烏魯賽),"[問卦] 美國黑道,真的會把屍體丟進哈德孫河嗎?",Sat Feb  6 02:38:35 2021
0,0,0,hayate232 (CY),Re,Sat Feb  6 01:27:56 2021
6,0,6,shintrain (戰犯分析師),[問卦] 他偷瞄我 我覺得不舒服,Sat Feb  6 00:29:17 2021
5,2,3,NTUST (國立金城武科技大學),[問卦] 現在是確定翁雞誰是加害者跟被害人了嗎,Fri Feb  5 23:52:47 2021
13,1,12,Sipaloy (便當),Re,Sat Feb  6 00:38:39 2021
86,5,81,cl3bp6 (來自97號世界),[新聞] 樹林女子從11樓墜落！1樓路過男子慘遭重,Fri Feb  5 22:33:12 2021
1,0,1,shonbig (香檳),[問卦] 有台男曾在日本被指控過性騷擾的嗎,Sat Feb  6 03:29:40 2021
0,0,0,tigotigo (鐵劍-中立理性選民),[問卦] 用雞排事件洗板的是哪些可撥仔？,Sat Feb  6 09:28:24 2021
4,1,3,ivorysoap (ivorysoap),[問卦] G排妹事件能寫成一條歌嗎？,Sat Feb  6 01:54:35 2021
242,10,232,taipei5566 (臺北56),[問卦] 翁立友和雞排妹閃婚的可能性,Sat Feb  6 02:50:57 2021
3,1,2,Ayanami5566 (綾波五六),[問卦] 處男哥哥要教我談戀愛該怎辦?,Fri Feb  5 23:59:46 2021
2,0,2,iphone15 (哀鳳15),Re,Sat Feb  6 01:00:48 2021
4,3,1,ilovettb (笑著笑著就哭了),[問卦] 為什麼羅時豐沒被千千告?,Fri Feb  5 23:27:57 2021
5,2,3,intrepid123 (勇氣),[問卦] 金城武不結婚不會很無聊嗎,Fri Feb  5 22:59:25 2021
1,1,0,oxygen718 (我的保溫杯),[問卦] G排484臭掉了？,Sat Feb  6 01:25:53 2021
11,13,-2,laiyuhao (0.0\),[新聞] 爛事變好事初衷變調 誰敢再學雞排妹指證,Sat Feb  6 09:09:10 2021
5,1,4,kuzu (酷蘇打☆クズだ),[問卦] 各位邊緣人怎麼加入clubhouse 的？,Sat Feb  6 08:54:58 2021
3,2,1,masi (專業酸民),[問卦] 三個妹仔要報隊該怎麼辦,Fri Feb  5 23:02:25 2021
4,1,3,k99t (聖誕小雞),[問卦] 有沒有當兵再健康的人都會生病的八卦？,Fri Feb  5 22:53:53 2021
4,1,3,lpbrother (LP哥(LP = Love & Peace)),[新聞] 屏東阿北車流路口徬徨險象環生　警緊急下,Sat Feb  6 07:18:42 2021
8,0,8,yorkyoung (約克羊),[問卦] 如果只能推薦一篇文，推哪篇？,Sat Feb  6 00:19:26 2021
1,0,1,Reichenau (RRR),Re,Sat Feb  6 01:45:24 2021
7,2,5,NSYSUEE (Monkey),[問卦] Only you 可以全身而退的方法,Fri Feb  5 22:20:56 2021
10,0,10,brownbear (熊國勞工),[協尋] 是不是有人的黑狗狗走丟了？,Fri Feb  5 22:33:16 2021
1,2,-1,ruby00514 (鬼滅秀柱-洪秀柱),[問卦] 如果今天是企鵝妹有騷擾風波會怎樣？,Fri Feb  5 23:14:49 2021
5,0,5,Aziz (Aziz),Re,Fri Feb  5 23:23:27 2021
1,0,1,ReiKuromiya (ReiKuromiya),Re,Fri Feb  5 22:55:10 2021
3,1,2,a78914124 (U文製造機),[問卦] 路西亞·烈惡古洛親艾麗算性騷擾嗎,Sat Feb  6 01:47:41 2021
8,8,0,masi (專業酸民),[問卦] 來這篇推我的都性騷擾,Fri Feb  5 22:14:02 2021
7,1,6,y303y191 (),[問卦] 私立醫院狂推自費開刀住院的八卦,Fri Feb  5 23:25:47 2021
27,4,23,hugh509 ((0_ 0)),[問卦] 一群iPhone在Clubhouse，安卓仔在想啥？,Fri Feb  5 23:30:25 2021
55,5,50,xo7796 (汐華 初流乃),[問卦] 說性騷就直接信的腦在哪？,Sat Feb  6 06:38:57 2021
8,0,8,lucien0410 (lucein),[問卦] 有沒有佑來了秀神奇蛋蛋的八卦？,Fri Feb  5 22:52:28 2021
1,0,1,abc60575986 (TAKA),[問卦] 害我想吃雞排,Sat Feb  6 01:28:03 2021
11,8,3,kuku951 (猴子),[爆卦]  黃威愷在clubhouse開麥拉,Fri Feb  5 23:24:41 2021
4,2,2,farmer (^_^),[問卦] 用純愛杯時要聽翁立友的哪首歌？,Sat Feb  6 05:19:48 2021
13,1,12,kaki1231 (亞亞),[問卦] 被抽電子煙的人嗆只是水蒸氣怎麼反駁,Fri Feb  5 22:56:36 2021
18,0,18,powerdavid (hatano yee),[爆卦] 俄羅斯驅逐波蘭 德國 瑞典外交官,Sat Feb  6 00:04:08 2021
3,1,2,sirius65482 (絕影),[問卦] 雞姐被性騷擾會怎樣?,Sat Feb  6 00:22:11 2021
5,1,4,z5419 (邱哥),[問卦] 各位覺得最好用的手機,Sat Feb  6 09:25:32 2021
11,2,9,Beanoodle (津崎似超人平匡先生),[問卦] 認真問，華山基金會如何？,Sat Feb  6 00:27:20 2021
2,0,2,ReiKuromiya (ReiKuromiya),Re,Sat Feb  6 01:31:03 2021
1,1,0,postit (擁有秘密是快樂的事),[問卦] 有沒有洗門風的八卦？,Fri Feb  5 23:46:18 2021
5,4,1,newwu (說不定我一生涓滴廢文),Re,Sat Feb  6 01:48:57 2021
0,0,0,peterpan0228 (haveapen),[問卦] 有沒有牙套專家,Fri Feb  5 23:06:13 2021
35,52,-17,norvasc (Norton),[問卦] 只有我覺得翁立友真的有摸雞排妹嗎,Sat Feb  6 07:12:36 2021
1,0,1,s523698 (523698),Re,Fri Feb  5 22:47:54 2021
3,0,3,toofat (南勢角野郎哥),[問卦] 花采列島的台灣最強的花見是？,Sat Feb  6 01:26:11 2021
5,1,4,Superxixai (洪粉吱已),[問卦] 菲律賓人，結婚之後都各玩各的喔？,Sat Feb  6 00:21:13 2021
6,1,5,saladim (殺拉頂),[問卦] Only You 後勢到底如何? 誰能大預測?,Fri Feb  5 23:09:14 2021
3,11,-8,ben28 (ben),[問卦] 性騷擾的人都會裝無辜和受害者,Sat Feb  6 07:51:52 2021
9,1,8,gmbad (jimmy113),[問卦] 翁立友平常講話也是這麼不順嗎,Sat Feb  6 09:18:36 2021
5,0,5,VVizZ (我很窮),Re,Sat Feb  6 03:24:25 2021
4,3,1,disgusting (噁心的),[問卦] 台北世貿一館外有異味,Sat Feb  6 08:05:25 2021
1,1,0,s12304569 (両津勘吉巡查長),[問卦] 以後是不是盡量和女孩兒不要有接觸比較好,Fri Feb  5 22:25:12 2021
9,0,9,poplc (),[問卦] G掰妹有女性朋友嗎?,Fri Feb  5 22:13:49 2021
19,23,-4,willy1281 (Ryan),[問卦] 翁立友記者會實在令人傻眼,Fri Feb  5 23:30:44 2021
1,1,0,akumakei (他們想要強奸我),[問卦] 最想帶誰回家過年  板主：愛莉莎莎,Sat Feb  6 00:05:36 2021
5,3,2,waterice0902 (默默淺水),[問卦] 男生出來指責被女生性騷擾有用嗎？,Sat Feb  6 00:47:07 2021
2,2,0,nowitzkixd (白雪公主與七位大巨人),Re,Sat Feb  6 09:11:38 2021
15,2,13,ironmanstock (鋼鐵人史塔克),"[問卦] 有沒有人看完雞2點聲明後,覺得很有問題？",Sat Feb  6 05:43:29 2021
1,0,1,Slemo (Forest),Re,Fri Feb  5 22:59:18 2021
36,4,32,Fujiwarano (獨孤浪客號：),[新聞] 如何讓中國回歸國際秩序 美戰略報告：只,Sat Feb  6 03:56:59 2021
0,0,0,LoveWin7 (WIN 7再戰10年),[問卦] 這次的風波會不會造成恐婚的人更多?,Fri Feb  5 23:11:51 2021
27,0,27,johnny9667 (大八),[問卦] 現在在上班又可以逛八卦版是做什麼工作?,Sat Feb  6 02:00:29 2021
3,3,0,stockeye (stockeye),[問卦] 接下來是不是賣10萬個中國飛機杯讀中山,Fri Feb  5 23:10:46 2021
13,5,8,Rueyh (追尋永遠),[新聞] 出庭被問雞排妹性騷風波 鈕承澤僅吐5個字,Sat Feb  6 09:05:27 2021
9,1,8,RyanBraun8 (RB8),[問卦] 台 日 韓哪一國生活壓力最大？？？,Fri Feb  5 22:37:46 2021
3,3,0,area41gold (area41gold在炫耀？哥單s),[問卦]翁立友是ptt的金城武吧？,Sat Feb  6 08:22:46 2021
2,0,2,kbt2720 (master),[問卦] 台灣女拳的卦,Sat Feb  6 03:08:43 2021
2,5,-3,imhimh (@@),[問卦] 雞排或許想從政 大家覺得呢,Fri Feb  5 23:34:31 2021
1,0,1,ILike58 (小菊花),Re,Sat Feb  6 00:33:02 2021
2,0,2,rich22084 (Siro),[問卦] 教主下一檔明燈是哪一家公司？,Sat Feb  6 06:48:10 2021
3,1,2,bearcsjc (),[問卦] 孕婦可以當支持人嗎？,Sat Feb  6 09:09:51 2021
6,0,6,tudo0430 (可愛いは正義であり！),[問卦] 美國麻將真的可以換三張牌嗎？,Sat Feb  6 08:52:05 2021
4,2,2,GUANGLEI (),[問卦] 幹 昨晚作惡夢了 怎麼辦,Sat Feb  6 07:21:09 2021
12,1,11,whitefox (黑心POWER終結者),[新聞] 部桃群聚+1 護理師女友家人又1確診,Sat Feb  6 06:37:45 2021
3,0,3,naligono (那尼),[問卦] 歐趴餐請學弟吃21風味館如何？,Sat Feb  6 00:57:01 2021
12,1,11,alien4024 (OA),Re,Sat Feb  6 04:56:38 2021
5,0,5,kevin19528 (kk19528),[問卦] 綠鬣蜥被消滅了嗎,Sat Feb  6 09:07:22 2021
6,0,6,"god46 (大家好,我是JayJay林俊傑)",[問卦] 八卦圖王是不是引退了？,Fri Feb  5 22:42:08 2021
9,4,5,z72117211 (高橋李依我老婆),[問卦] 2000以下的藍芽耳機都爛貨吧？,Fri Feb  5 23:16:48 2021
7,3,4,k99t (聖誕小雞),[問卦] 我們的國道為什麼沒有路燈 這麼窮嗎?,Fri Feb  5 23:16:43 2021
0,0,0,vyjssm (散人),Re,Sat Feb  6 09:21:11 2021
9,1,8,king665714 (花生嬸魔術),[問卦] 大家從哪時開始覺得過年失去年味的？,Sat Feb  6 01:53:36 2021
12,0,12,kooyoo1144 (安安),[協尋] 求高雄博愛路明誠路口行車記錄器,Mon Feb  1 18:46:37 2021
2,2,0,WWIII (東邪西毒),[問卦] 美國人怎麼那麼愛打槍??,Sat Feb  6 00:24:10 2021
8,1,7,gogosonny (狗狗桑妮),[問卦] 如果翁跟為廷一樣道歉會怎樣?,Fri Feb  5 23:59:51 2021
34,200,-166,losel (),[新聞] 雞排妹再嗆翁立友「這四個字」 網:愛上這,Fri Feb  5 23:18:12 2021
2,0,2,BlueBird5566 (唯一支持蔡英文),[問卦] 有沒有爸！爸節！的八卦！,Sat Feb  6 09:02:53 2021
14,0,14,dank0506 (qqbow),[問卦] 空氣很糟糕,Sat Feb  6 01:11:28 2021
0,1,-1,stradadelsol (史抓達達獸),[問卦] 油妹油雞排腥騷味很重很困擾der叭呱？,Sat Feb  6 00:53:19 2021
18,0,18,orangelolly (我戀橘羅莉。夏流),[問卦] 在外島適合聽的歌 有哪些?,Sat Feb  6 07:54:49 2021
4,4,0,s6307 (亮晶晶),[問卦] 成立一個國家有多難？,Fri Feb  5 23:28:48 2021
2,0,2,LoveWin7 (WIN 7再戰10年),Re,Sat Feb  6 00:27:11 2021
0,1,-1,akumakei (他們想要強奸我),Re,Sat Feb  6 01:19:29 2021
15,47,-32,hello456 (好無聊......),[新聞] 蓋亞那台灣辦公室破局！陳柏惟：內奸病毒,Sat Feb  6 00:02:31 2021
48,13,35,UNT (UNT),[問卦] 雞排妹被性騷擾的當時為什麼不出聲？,Fri Feb  5 22:21:35 2021
40,2,38,IdiotMa19 (請Q我 >///<),[問卦] 為什麼提告會回想起痛苦回憶，但是鬧場不,Sat Feb  6 02:21:41 2021
1,2,-1,scopeowl (看海...),[問卦] 雞屁股事件最大贏家是不是色狼癡漢？,Sat Feb  6 07:14:25 2021
13,1,12,ohfly (行動才是真實的),[問卦] 雞排妹今年尾牙接了幾場？,Sat Feb  6 07:55:21 2021
7,1,6,ptgeorge2 (左輪小手槍),[問卦] 雞排妹是接下來要替女性發聲參選?,Fri Feb  5 23:27:57 2021
7,2,5,dinghaipi (果凍魚),[問卦] 陸戰隊給的是步槍，不是翅膀怎麼辦,Sat Feb  6 09:13:54 2021
7,1,6,lwt501cx (超高校級の百合厨),Re,Fri Feb  5 22:11:05 2021
29,78,-49,ayayaya (aya),[爆卦] 阿純開講啦！,Fri Feb  5 23:12:02 2021
1,0,1,hayate232 (CY),Re,Fri Feb  5 23:19:51 2021
2,0,2,poonebetty (小肥媽),[問卦] 台灣演藝圈怎麼沒有me too效應,Sat Feb  6 00:31:06 2021
19,15,4,henry1881 (BIRD),[問卦] 我覺得重點不完全是性騷擾，是被欺負,Sat Feb  6 03:04:26 2021
2,0,2,organ63521 (期望越大＝失望越大),[問卦] 有沒有吉翁的八卦？,Sat Feb  6 09:33:59 2021
3,0,3,zbo5566 (高級酸民),Re,Fri Feb  5 22:52:45 2021
3,0,3,akuan413 (...),[問卦] 有雞排妹 有沒有豬排妹？,Fri Feb  5 22:13:51 2021
18,3,15,ElizabethXIV (應許),[問卦] 這次性騷擾大概還可以吵多久,Sat Feb  6 01:15:24 2021
26,102,-76,micheal59 (爪爪我驕傲),[新聞] 雞排妹深夜吐心聲　坦言「邰智源、許效,Sat Feb  6 00:17:32 2021
7,1,6,XXXXPOXXXX (彈跳甲魚湯),[問卦] 哪些工作夜班都很恐怖？,Sat Feb  6 02:54:52 2021
2,1,1,osalucard (墮落的月光),Re,Fri Feb  5 22:32:47 2021
198,17,181,ntlutw (Louis888),[新聞] 辯與關西機場無關 檢批長期有犯意聯絡！,Sat Feb  6 07:42:58 2021
0,0,0,yata4547 (yata),[問卦] 為什麼雞排妹要追打摸屁股的不是摸胸的,Sat Feb  6 09:29:05 2021
6,1,5,hazel0093 (飛龍がくる),[問卦] 菲哥不出來發聲一下？,Fri Feb  5 22:29:01 2021
7,14,-7,Whitening (whitening),[問卦] 結果來看only you是不是輸了?,Sat Feb  6 07:35:27 2021
6,0,6,yorkyoung (約克羊),[問卦] 如果今天開記者會的是艾主席會怎麼演,Fri Feb  5 22:27:39 2021
2,0,2,CREA (自由滞在),Re,Fri Feb  5 23:50:10 2021
7,2,5,iphone15 (哀鳳15),[問卦] 老外：台灣人哪些話不能照字面解讀？,Sat Feb  6 00:13:28 2021
39,1,38,pchion2002 (阿我就怕被罵阿),[問卦] 雞排妹說的黑道是誰,Fri Feb  5 22:52:25 2021
2,0,2,hayate232 (CY),[問卦] 有沒有三國群英傳Online的八卦?,Sat Feb  6 02:32:55 2021
29,10,19,takizawa5566 (本島皇民　滝沢),[新聞] 陳為廷私下是什麼人，對任何人都不重要,Sat Feb  6 09:06:16 2021
8,1,7,Pixma258 (鄉民們!別爭了!!),[問卦] 女權被無限上崗，為什麼不能反,Sat Feb  6 01:42:17 2021
10,1,9,d0922030 (J系),[問卦] 保險公司是不是可以推出性騷擾套餐,Sat Feb  6 02:15:27 2021
12,7,5,go190214 (天空之島拉普達),[新聞] 蓋亞那「台灣辦公室」沒了 網驚：這巴掌,Sat Feb  6 00:50:59 2021
4,0,4,loken0408 (男人野蠻劍),[問卦] 單人用餐收開鍋費是不是歧視,Sat Feb  6 01:31:02 2021
6,2,4,iamgaylan (),[問卦] 在早餐店逮到一整車的梅花 怎辦,Sat Feb  6 09:18:32 2021
3,0,3,deepdish (Keep The Faith),[問卦] 有沒有 Peer pressure 同儕壓力的八卦？,Sat Feb  6 02:16:43 2021
3,0,3,ydee (小荔枝),[協尋] 行車記錄器影片,Wed Feb  3 19:36:00 2021
10,8,2,Whitening (whitening),[問卦] 翁為何不學城城哥開個玩笑就過了?,Fri Feb  5 23:47:12 2021
5,5,0,wenning (花花的小森林),[問卦] 演藝圈大哥們多少都翁過吧,Sat Feb  6 08:14:30 2021
9,0,9,lockinboy (嘿唷嘿唷),[問卦] 捷運被罷會怎樣？,Sat Feb  6 08:54:16 2021
14,5,9,NUMB43 (晚了~該睡了),[問卦] 巨人動畫為何炒不起來,Sat Feb  6 00:07:15 2021
27,24,3,gentleman888 (),[新聞] 美國一中表態 陸央視：讓台獨分子看清自,Sat Feb  6 08:14:49 2021
8,1,7,PRME (我被水桶拉),[問卦] 翁立友是不是買100飛機杯就沒事了？,Sat Feb  6 07:46:03 2021
1,5,-4,aventardorsv (lamborghini aventadorsv),[問卦] 嘻嘻☺  肥宅請正妹吃愛心吐司有加分嗎？,Sat Feb  6 08:58:53 2021
1,2,-1,alod1023 (alod),[新聞] 亞洲．矽谷創新研發中心遭爆料有弊端 將,Fri Feb  5 23:30:46 2021
4,0,4,LeonardoChen (LeonardoChen),Re,Sat Feb  6 02:04:39 2021
2,0,2,clubbox (史上最強7788 ),[問卦] only u 霸氣買100個飛機杯是不是就贏了,Sat Feb  6 02:33:36 2021
19,4,15,tadshift2 (煞氣的毛),[問卦] 雞排妹對於司法的態度正確嗎？,Sat Feb  6 04:23:33 2021
0,0,0,Qorqios (雲☁傲嬌銀長直JK),Re,Sat Feb  6 00:18:04 2021
2,1,1,x5533007 (Magneto),[問卦] 看著鳳山霸凌影片 然後ininder怎辦..,Sat Feb  6 01:42:17 2021
3,1,2,geige (),Re,Sat Feb  6 00:34:47 2021
1,0,1,protoss (天生散人),Re,Sat Feb  6 03:15:57 2021
2,3,-1,eierom (非),[問卦] 只有我認為是在炒熱度嗎？,Sat Feb  6 07:55:34 2021
10,0,10,NUMB43 (晚了~該睡了),[問卦] 醫療救護行為會被告性騷擾嗎,Sat Feb  6 02:50:49 2021
9,1,8,girl55665566 (同志友善ID),[問卦] 韓國版本的段譽是最難看的天龍八部嗎,Fri Feb  5 23:54:28 2021
6,1,5,oSCo (SC),Re,Sat Feb  6 08:55:53 2021
0,7,-7,tsaiss (Samkh),[問卦] 太早起怎麼辦？,Sat Feb  6 04:28:10 2021
26,12,14,op840906 (LOVEISFOURLETTERSWORS),[問卦] 幹，為什麼台灣不要全面改西元紀年？？？,Sat Feb  6 08:25:48 2021
11,4,7,area41gold (area41gold在炫耀？哥單s),[問卦]翁立友根本台灣的基努李維！,Sat Feb  6 06:40:31 2021
11,5,6,thefworld (happiness),[問卦] 吸毒如何傾家蕩產? ,Fri Feb  5 22:16:13 2021
0,0,0,zxcv91039 (肥宅),Re,Sat Feb  6 08:36:55 2021
9,0,9,LeonardoChen (LeonardoChen),[問卦] 看到女生哭就相信她的人是白痴吧？,Sat Feb  6 01:05:36 2021
283,29,254,whj0530 (億載金城武),[新聞] 狂怒罵雞排妹大媽身份揭曉　翁立友女粉台,Fri Feb  5 22:41:17 2021
1,0,1,Riankuo (安吸教練 我想打球),[問卦] 台x大網路到半夜12:30分都會準時斷線?,Sat Feb  6 00:46:48 2021
1,2,-1,LukeSkywaker (路克天醒者),[問卦] 找不到能配宵夜的劇，怎辦？急在線等,Sat Feb  6 00:23:15 2021
3,2,1,bornwinner (純情小黃瓜),[問卦] 當初的小黃司機是怎麼澄清沒摸奶的？,Sat Feb  6 00:10:35 2021
2,0,2,kaky (菩提本無樹明鏡亦非台),Re,Fri Feb  5 23:36:21 2021
18,4,14,zoeapezoo (),Re,Fri Feb  5 22:15:21 2021
5,0,5,three88720 (不要跟我起爭yee啦!),[問卦] 為什麼環狀線班次間隔時間可以這麼久,Sat Feb  6 08:58:14 2021
15,0,15,vcvca5566 (vcvca),[新聞] 是否協助台灣取得疫苗 德國避而不談,Sat Feb  6 05:41:02 2021
1,0,1,node1 (我是主節點),Re,Fri Feb  5 23:31:56 2021
4,1,3,direct (【強迫練鐵頭功】),Re,Sat Feb  6 08:15:32 2021
4,0,4,HuangJC (吹笛牧童),Re,Sat Feb  6 04:20:44 2021
3,0,3,deepdish (Keep The Faith),[問卦] 有沒有 Conformity 從眾行為的八卦？,Sat Feb  6 01:57:35 2021
44,27,17,bob120400 (花滿樓),[問卦] 正常人都會支持翁立友吧,Sat Feb  6 02:37:03 2021
5,0,5,WolfTeacher (狼師),[問卦] 怎麼新聞一直報雞排妹，怎不報口交惡徒?,Fri Feb  5 23:34:42 2021
0,5,-5,zxc445567 (飄飄),[問卦] 雞排妹發生在日韓是不是沒人理啊?,Sat Feb  6 00:03:34 2021
6,0,6,arfa0711 (吃青椒),[問卦]  大家會羨慕人緣好或開心果嗎？,Sat Feb  6 00:23:32 2021
17,2,15,z72117211 (高橋李依我老婆),[問卦] 鯡魚罐頭 真的很臭？,Sat Feb  6 08:31:20 2021
4,2,2,orangelolly (我戀橘羅莉。夏流),[問卦] 單身老魯過年該怎麼過?,Sat Feb  6 08:21:55 2021
0,0,0,arsl400 (dark hatter),Re,Fri Feb  5 23:15:17 2021
6,5,1,illmatic (我爪我驕傲),[問卦] 為什麼雞排妹還是拿不出證據?,Sat Feb  6 04:52:17 2021
8,2,6,Superxixai (洪粉吱已),[問卦] 高中生能寫出碩論，為什麼不是科學強國,Fri Feb  5 23:02:56 2021
6,7,-1,haudai (低調),Re,Fri Feb  5 23:52:43 2021
5,0,5,y303y191 (),[問卦] 榮總是醫院霸主嗎,Fri Feb  5 22:45:22 2021
0,2,-2,akumakei (他們想要強奸我),Re,Sat Feb  6 00:37:33 2021
7,1,6,claymath (ヽ(‵・ω・′)ゝ),[問卦] 不帥的人該怎麼自保？,Sat Feb  6 08:59:43 2021
23,4,19,inet (),[問卦] 高雄和台南要住哪裡？,Fri Feb  5 22:18:18 2021
11,4,7,toopure (純真),[問卦] Only you只要回答這幾個問題就好,Sat Feb  6 00:15:56 2021
3,0,3,pauljet (拜登哥不要),Re,Sat Feb  6 00:16:29 2021
3,0,3,Tapqou (三三三),Re,Fri Feb  5 22:20:32 2021
9,17,-8,bul (腹內原來草莽),[新聞] 驚吐「從以前就討厭雞排妹」！宅神親揭2,Sat Feb  6 02:28:45 2021
6,0,6,p69005103 (ANDY),[問卦] 翁立友如果選立委會在哪區選?,Sat Feb  6 00:06:02 2021
6,0,6,snakei14702 (sun抓奶廷已經gg了怎麼뼺),[問卦] 所以雞排妹只想要onlyyou社會死而？,Sat Feb  6 01:42:17 2021
2,8,-6,trylin (心地善良的阿肥),[問卦] 要我~怎麼撿  ....,Sat Feb  6 00:27:46 2021
2,4,-2,hoanbeh (初入江湖淨添堵),[問卦] 94版三國演義 嫂嫂陷落是什麼意思？,Fri Feb  5 23:26:42 2021
8,5,3,girl55665566 (同志友善ID),[公告] 按下大寫V投票吧！！！水桶,Fri Feb  5 22:53:28 2021
1,0,1,newsyho (newsyho),[問卦] 嘴喊樹立典範結果誤導受害者是哪招?,Sat Feb  6 06:33:34 2021
7,0,7,AllBlack (All Black),[問卦] 中國人在clubhouse統戰台灣人的卦？,Sat Feb  6 01:23:47 2021
6,6,0,yahe0526 (有一種預感 發廢文好難),[問卦] 如果只能推薦一部電影 推哪部??,Sat Feb  6 00:11:12 2021
0,0,0,gtoselina (啾啾),[問卦] 為什麼現在臉書打卡沒有隱+N了？,Sat Feb  6 01:45:40 2021
4,3,1,zz2895341 (煙大屌宅男),[問卦] 朋友的朋友好像不太懂我的幽默,Sat Feb  6 04:36:06 2021
4,2,2,haudai (低調),[問卦] 是大雄是對小夫性騷擾還是胖虎對大雄性騷,Fri Feb  5 23:59:32 2021
17,2,15,td123 (內行人),[問卦] 雞排妹守得住Lebron James嗎？,Fri Feb  5 22:35:20 2021
9,3,6,balu770303 (充實的活著就已足夠),[問卦] 有沒有三熊圖消失的八卦？,Sat Feb  6 01:52:18 2021
8,4,4,derekhsu (華麗的天下無雙),[問卦] 台灣的司法改革是不是失敗了？,Sat Feb  6 00:27:00 2021
1,0,1,a6000200 (aa),[問卦] 服務業是不是比較好,Sat Feb  6 01:13:03 2021
13,0,13,Kingisland (國王島),[問卦] 性騷擾事件是要吵多久?,Sat Feb  6 07:55:17 2021
0,0,0,Lawleit (大員郭奉孝),[問卦] 26節要做什麼活動慶祝？,Sat Feb  6 01:56:38 2021
4,4,0,crr122oe (嘻嘻嘻),[問卦] 翁立友為什麼不自訴？,Fri Feb  5 23:18:49 2021
14,7,7,badjye911 (阿三),[問卦] 有的女生過了27歲之後爆幹正的八卦？,Sat Feb  6 03:14:50 2021
1,0,1,efthu456 (小哲),[問卦] 楓之谷買點裝 有加分嗎？,Fri Feb  5 22:52:20 2021
125,61,64,subway0983 (巴巴),[問卦] 等等八點要集合入伍了.....,Sat Feb  6 04:59:39 2021
21,9,12,kikiki37 (441),[問卦] 雞排妹事件，八卦板是不是反指標?,Sat Feb  6 08:44:56 2021
2,1,1,leona12 (leona12),[問卦] 去酒店會被申訴性騷擾嗎？,Sat Feb  6 00:18:56 2021
2,0,2,CCMg (☜㊣ⒸⒸⓂⓖ♥☞),[問卦] 被性騷擾的時候怎樣蒐證較好？,Fri Feb  5 22:15:14 2021
3,0,3,ISAM1 (近藤勇),Re,Sat Feb  6 01:03:26 2021
5,3,2,iecju520 (哎依喜德魯),[問卦] 現在濕氣90%要開暖氣還是除濕機,Sat Feb  6 01:56:44 2021
5,0,5,sweetmiki (米奇Tama子),[問卦] 我想到一個杜絕噁男朋友的方法了,Sat Feb  6 02:09:54 2021
2,0,2,johnhmj (耗呆肥羊),[問卦] 一個神經元讓你存在？,Sat Feb  6 00:05:11 2021
1,0,1,td123 (內行人),[問卦] 翁立友要解套 是不是只能學阿趴了？,Fri Feb  5 22:53:12 2021
3,2,1,ChrisAJ (阿杰),[問卦] iPhone疑似被駭客入侵？,Sat Feb  6 08:48:56 2021
8,2,6,idontsuck (╯▽╰),[問卦] 放棄演藝圈，進軍政治圈?,Fri Feb  5 23:03:12 2021
16,1,15,huangmingwei (寒夜),[新聞] 嚴重空汙！ 西部全面滿江紅 這些地區避免,Sat Feb  6 07:56:47 2021
3,1,2,Zcould (宇宙覺青網軍蟑螂),[問卦] 如何比對方先發現自己像是在生氣？,Fri Feb  5 22:23:48 2021
9,0,9,lovea (lovea),[問卦] 如果出國困難情形持續超過10年會怎樣??,Fri Feb  5 22:48:39 2021
16,0,16,atp3306 (ggininder),[問卦] ktv必點什麼歌啊,Sat Feb  6 02:14:46 2021
8,0,8,odasaku (鹹魚),[問卦] 開這台車上班的都是什麼人呀,Sat Feb  6 08:45:43 2021
10,1,9,a11111a4210 (clh),[問卦] 有五甲人才是今天真正的主角的卦?,Sat Feb  6 07:15:53 2021
0,0,0,coupon (越想越不對),Re,Fri Feb  5 23:49:16 2021
10,2,8,Ayanami5566 (綾波五六),[問卦] 明天第一次去火鍋店打工，要注意什麼?,Fri Feb  5 22:14:58 2021
49,4,45,LEDG (雪),[問卦] 翁立友在台語界的地位，是國語歌手的誰？,Fri Feb  5 23:38:35 2021
7,1,6,godshibainu (神柴),[問卦] PC線上養成遊戲 有人懷念嗎？還有救？,Sat Feb  6 03:32:23 2021
9,2,7,ifromtaiwan (),[問卦] PS5、羅技方向盤、VR，都幾？,Fri Feb  5 22:15:42 2021
49,3,46,yahe0526 (有一種預感 發廢文好難),[問卦] 賈靜雯演的倚天屠龍記當年有很紅嗎??,Fri Feb  5 23:28:49 2021
0,0,0,wvookevp (ushiromiya),[問卦] ko榜是騙人做武屍用的陷阱嗎,Sat Feb  6 00:17:47 2021
4,1,3,horsehead (小孩臉),Re,Sat Feb  6 00:20:38 2021
2,1,1,mean (低智商生活),Re,Sat Feb  6 04:35:26 2021
2,1,1,suckdickman (不以ID廢言),[問卦] 如果有個肥婆,Sat Feb  6 00:50:27 2021
148,22,126,UNT (UNT),[新聞] 雞排妹性騷風波延燒 衛福部:性騷案件倍增,Sat Feb  6 00:04:15 2021
9,0,9,Ncyu2 (解鈴還須繫鈴人),[問卦] 有沒有翁講話很慢的八掛,Fri Feb  5 22:39:26 2021
4,2,2,sweetmiki (米奇Tama子),[問卦] 飛機杯的使用者想到代言人也是性騷擾嗎,Sat Feb  6 02:41:34 2021
7,6,1,DFIGHT (Dknight),[新聞] China’s latest weapon against Taiwan,Sat Feb  6 03:03:59 2021
3,0,3,posen2012 (posen),[問卦] 阿福王為啥不再po阿福文了？,Fri Feb  5 22:25:55 2021
4,0,4,q76347kimo (q76347kimo),Re,Sat Feb  6 00:13:18 2021
11,1,10,bigbowl ( Gathering Storm。),Re,Sat Feb  6 03:02:50 2021
26,3,23,k44754 (9527),Re,Fri Feb  5 22:17:38 2021
17,6,11,mariewtsai (是狗狗可愛還是貓貓可愛),[問卦] 鹹豆漿加什麼才是內行？,Sat Feb  6 05:14:00 2021
13,0,13,shoppinglin (Shopping),[問卦] 性騷擾的定義?,Sat Feb  6 02:12:00 2021
20,1,19,juicypussy (多汁小貓咪),[問卦] 什麼時候會脫口說出「死台女」,Sat Feb  6 03:33:20 2021
16,2,14,a0912096896 (DFL),Re,Sat Feb  6 08:21:00 2021
2,2,0,hunda1250 (H.A),[問卦] iTunes 魔戒跟哈利波特套裝要買哪個,Sat Feb  6 00:19:28 2021
20,8,12,ashin0709 (),[新聞] 19歲屁孩「機車衝雪隧」哭哭怪導航　警,Sat Feb  6 00:18:13 2021
15,0,15,ilove640 (子夜),[問卦] 所以可以推行性別專車了嗎？,Sat Feb  6 00:43:43 2021
7,2,5,ComeThrough (☁),[問卦] 汐止人會支持雞排妹參選嗎？,Fri Feb  5 23:36:12 2021
8,1,7,"chungrew (work hard, play hard)",[問卦] 請教性騷擾的主觀成分究竟要怎麼判斷？,Sat Feb  6 00:18:42 2021
7,2,5,kopuck (派翠克星星),[問卦] 8+9味講女生是什麼概念,Sat Feb  6 09:10:04 2021
2,6,-4,waymayday (不要問),[問卦] 去洗頭大奶妹又摸又柔,Sat Feb  6 00:14:01 2021
7,0,7,douCai (D能統粉),[問卦] 雞排妹的經紀人案發當時在做啥?,Fri Feb  5 22:40:09 2021
2,0,2,huangmingwei (寒夜),[問卦] 真實性侵無人問  性騷疑雲眾媒驚,Fri Feb  5 23:25:54 2021
165,26,139,yoyodiy (廢文心得文大師),[問卦] 雞排妹在八卦支持度遠遜翁立友是忌妒心嗎,Fri Feb  5 22:56:37 2021
2,0,2,himthin02 (陰x 02),[問卦] 為什麼沒有男星出屌模做假屌？,Fri Feb  5 23:00:45 2021
5,2,3,chentosi1217 (Love0116),[問卦] 沒有被邀進clubhouse的都是魯蛇嗎？,Sat Feb  6 00:33:57 2021
4,1,3,eachen (易陳),Re,Fri Feb  5 22:27:29 2021
76,12,64,MikuLover (愛ミク的人),[新聞] 疫情影響　想正常生活恐還需7.4年,Sat Feb  6 05:55:12 2021
7,0,7,ltyintw (菈米雅嘶嘶),[問卦] 什麼情況下看到有人婊台灣不會7PUPU?,Sat Feb  6 06:58:17 2021
10,1,9,orangelolly (我戀橘羅莉。夏流),[問卦] 香港漫畫的人物,Sat Feb  6 08:01:02 2021
11,6,5,coga4712 (海森堡),[問卦] 急！腸胃炎吃這樣夠嗎？ 圖,Sat Feb  6 00:29:23 2021
9,3,6,StarTouching (撫星),[問卦] 要翁立友提告的是不是智障?,Fri Feb  5 23:15:43 2021
1,3,-2,sasolala (殺手拉拉),[問卦] 男生長得不帥 是不是不該在職場言語騷擾,Sat Feb  6 01:09:14 2021
3,1,2,ich2 (北川石原都是我老婆),[問卦] 現在當兵還有洞八嗎,Sat Feb  6 08:46:05 2021
4,1,3,k321045 (蒜泥厲害),[問卦] 如果豆導將雞排妹事件拍成電影要怎麼演,Sat Feb  6 01:06:25 2021
9,0,9,seibu (難過),[新聞] 邀同學陪媽媽看病 孝子目睹母駕車國道翻,Sat Feb  6 07:56:36 2021
1,2,-1,ffreakk (),[問卦] 肥宅過年要囤什麼,Fri Feb  5 23:15:39 2021
65,13,52,meta41110 (阿標),[新聞] 蓋亞那外長稱設立「台灣辦公室」原意沒錯,Sat Feb  6 07:04:59 2021
4,2,2,howard24 (howtw24),[問卦] 急!團長叫我們一直前進,Sat Feb  6 00:13:13 2021
2,1,1,jones921245 (jones),[問卦] 等等要搭高鐵怎麼辦？,Sat Feb  6 08:58:26 2021
2,0,2,qazsedcft (自由羊),[問卦] 雙手是女朋友算不算物化,Sat Feb  6 06:24:27 2021
8,0,8,design0606 (飛),Re,Fri Feb  5 22:53:57 2021
2,6,-4,afacebook (gg),[問卦] 大家覺得雞排妹嫁得掉嗎?,Fri Feb  5 23:14:22 2021
13,0,13,callwilliam (丁神),[問卦] 雞翁事件是想掩蓋什麼真相,Fri Feb  5 23:48:50 2021
13,1,12,HDSM (Love Not Change  O'_'O),[問卦] 灌籃高手片頭片尾曲哪首比較經典？,Sat Feb  6 00:15:31 2021
0,0,0,DustToDust (活得痛快 死得年輕),Re,Fri Feb  5 23:52:31 2021
0,0,0,housemance (艾倫戴爾皇家空軍總司令),[問卦] 有沒有發生重大事件哪類人最能適應的八,Fri Feb  5 23:27:44 2021
11,4,7,pxycho (trolltrolltroll),[問卦] 有沒有當婊子又要立牌坊的八卦？,Sat Feb  6 09:21:31 2021
0,0,0,s12304569 (両津勘吉巡查長),Re,Fri Feb  5 23:28:44 2021
6,0,6,WeiU (微，Ｕ文),"[問卦] 社會系哲學系等,臉書平常都分享甚麼?",Sat Feb  6 01:58:18 2021
2,5,-3,bs167512 (hyacinth),[問卦] [問卦] 性騷擾是何時發明的名詞,Sat Feb  6 00:08:19 2021
2,3,-1,cuba391156 (cuba391156),[問卦] 女生這樣算胖嗎？,Sat Feb  6 01:30:59 2021
2,2,0,CSMUck (人氏言周),[問卦]  失控打滑撞火車的話,Fri Feb  5 23:21:49 2021
29,6,23,misaka0120 (野格炸彈),[問卦] 急！老師把愛滋血加到學生的牛奶裡,Sat Feb  6 02:39:31 2021
3,1,2,TaiwanDPP (偉),[問卦] 如何偷偷性騷擾別人而不被發現？,Sat Feb  6 08:12:55 2021
5,4,1,wegoWU (辜菀允鐵粉♥ ),[問卦] 有沒有推薦的客家健身法?,Fri Feb  5 23:05:18 2021
8,0,8,moslaa (萬變蛾),Re,Sat Feb  6 02:40:57 2021
1,0,1,gk1329 (),Re,Fri Feb  5 22:19:16 2021
7,1,6,farmer (^_^),[問卦] 館長+雞排有辦法擊沉憲哥嗎？,Fri Feb  5 22:41:07 2021
2,1,1,dank0506 (qqbow),[問卦] 萊豬,Sat Feb  6 01:22:10 2021
10,3,7,efthu456 (小哲),[問卦] 現在還沒睡的 是鬼吧！,Sat Feb  6 04:57:45 2021
0,1,-1,orangelolly (我戀橘羅莉。夏流),[問卦] 潛規則 被爆出來 還叫潛規則嗎?,Sat Feb  6 00:14:39 2021
44,6,38,girl55665566 (同志友善ID),[公告] 2021年2月八卦板主徵選投票開始,Thu Feb  4 20:41:56 2021
6,0,6,hogarth1985 (扣一八一),[問卦] 疑似性騷擾受害人新聞卻直接屬名的目的?,Fri Feb  5 23:25:16 2021
2,1,1,FAYeeeeeeee (Fay),[問卦] 替補球員一上場就摸屁股？,Fri Feb  5 23:49:35 2021
5,2,3,jazzcai (如果有一天),[問卦] 如果如花被性騷擾新聞會報這麼大嗎？,Sat Feb  6 08:52:10 2021
11,5,6,TBOC (花嚴),[新聞] 【剩新北堅持用】花2億「裝好看」　區間,Fri Feb  5 22:52:47 2021
18,12,6,fuxdk (負能量大師),[問卦] 幹你娘真的被版友說中了,Fri Feb  5 23:54:23 2021
8,0,8,ReiKuromiya (ReiKuromiya),[問卦] 中條彩未是不是接到僵絲糞劇了,Sat Feb  6 00:36:35 2021
6,3,3,jackymars5 ((                )),[問卦] 人不一定要活的久，要活的有價值,Fri Feb  5 22:19:18 2021
0,0,0,VVizZ (我很窮),[問卦] 為什麼女拳要罵翁立友媽寶?,Sat Feb  6 09:27:09 2021
1,0,1,mean (低智商生活),Re,Sat Feb  6 06:54:19 2021
8,1,7,OPPAISuki (OPPAISuki),[問卦] 田馥甄發專輯無人知曉??,Sat Feb  6 01:02:37 2021
5,0,5,orangelolly (我戀橘羅莉。夏流),[問卦] 無名VS劍聖,Fri Feb  5 22:54:00 2021
3,0,3,yaotz5065 (咿喔),[問卦] 有沒有only you和警政時報的掛？,Sat Feb  6 08:39:06 2021
3,0,3,Qorqios (雲☁傲嬌銀長直JK),[問卦] 半夜肚子會餓到雷鳴八卦嗎？,Sat Feb  6 00:24:01 2021
47,12,35,JRSmith (我兩冠你們幾冠),[問卦] 雞排妹之前形象怎麼這麼好？,Sat Feb  6 08:33:13 2021
9,0,9,f22313467 (軍曹),[問卦] 雞排妹事件是不是明天就沒人理了,Fri Feb  5 23:16:33 2021
516,14,502,ghost90331 (蘭陽金城武),[問卦] 跟我說聲加油好嗎,Sat Feb  6 06:00:49 2021
